1111111111111
1EC0000P001C1
1111111111111