11111111111111111111111111111111111111111111111111111111111111111111111111111111111111111111111111111111111111111111111111111111
1P000000000000000000C00000000000000000000000000000000000000000000000000000000000000000000000000000000000000000000000000000C00001
10000000000000000000000000000000000000000000000000000000000000000000000000000000000000000000000000000000000000000000000000C00001
10000000000000000000000000000000000000000000000000000000000000000000000000000000000000000000000000000000000000000000000000C00001
10000000000000000000000000000000000000000000000000000000000000000000000000000000000000000000000000000000000000000000000000C00001
10000000000000000000000000000000000000000000000000000000000000000000000000000000000000000000000000000000000000000000000000C00001
10000000000000000000000000000000000000000000000000000000000000000000000000000000000000000000000000000000000000000000000000C00001
10000000000000000000000000000000000000000000000000000000000000000000000000000000000000000000000000000000000000000000000000C00001
10000000000000000000000000000000000000000000000000000000000000000000000000000000000000000000000000000000000000000000000000C00001
10000000000000000000000000000000000000000000000000000000000000000000000000000000000000000000000000000000000000000000000000C00001
10000000000000000000000000000000000000000000000000000000000000000000000000000000000000000000000000000000000000000000000000C00001
10000000000000000000000000000000000000000000000000000000000000000000000000000000000000000000000000000000000000000000000000C00001
10000000000000000000000000000000000000000000000000000000000000000000000000000000000000000000000000000000000000000000000000C00001
10000000000000000000000000000000000000000000000000000000000000000000000000000000000000000000000000000000000000000000000000C00001
10000000000000000000000000000000000000000000000000000000000000000000000000000000000000000000000000000000000000000000000000C00001
10000000000000000000000000000000000000000000000000000000000000000000000000000000000000000000000000000000000000000000000000C00001
10000000000000000000000000000000000000000000000000000000000000000000000000000000000000000000000000000000000000000000000000C00001
10000000000000000000000000000000000000000000000000000000000000000000000000000000000000000000000000000000000000000000000000C00001
10000000000000000000000000000000000000000000000000000000000000000000000000000000000000000000000000000000000000000000000000C00001
10000000000000000000000000000000000000000000000000000000000000000000000000000000000000000000000000000000000000000000000000C00001
10000000000000000000000000000000000000000000000000000000000000000000000000000000000000000000000000000000000000000000000000C00001
10000000000000000000000000000000000000000000000000000000000000000000000000000000000000000000000000000000000000000000000000C00001
10000000000000000000000000000000000000000000000000000000000000000000000000000000000000000000000000000000000000000000000000C00001
10000000000000000000000000000000000000000000000000000000000000000000000000000000000000000000000000000000000000000000000000C00001
10000000000000000000000000000000000000000000000000000000000000000000000000000000000000000000000000000000000000000000000000C00001
10000000000000000000000000000000000000000000000000000000000000000000000000000000000000000000000000000000000000000000000000C00001
10000000000000000000000000000000000000000000000000000000000000000000000000000000000000000000000000000000000000000000000000C00001
10000000000000000000000000000000000000000000000000000000000000000000000000000000000000000000000000000000000000000000000000C00001
10000000000000000000000000000000000000000000000000000000000000000000000000000000000000000000000000000000000000000000000000C00001
10000000000000000000000000000000000000000000000000000000000000000000000000000000000000000000000000000000000000000000000000C00001
10000000000000000000000000000000000000000000000000000000000000000000000000000000000000000000000000000000000000000000000000C00001
10000000000000000000000000000000000000000000000000000000000000000000000000000000000000000000000000000000000000000000000000C00001
10000000000000000000000000000000000000000000000000000000000000000000000000000000000000000000000000000000000000000000000000C00001
10000000000000000000000000000000000000000000000000000000000000000000000000000000000000000000000000000000000000000000000000C00001
10000000000000000000000000000000000000000000000000000000000000000000000000000000000000000000000000000000000000000000000000C00001
10000000000000000000000000000000000000000000000000000000000000000000000000000000000000000000000000000000000000000000000000C00001
10000000000000000000000000000000000000000000000000000000000000000000000000000000000000000000000000000000000000000000000000C00001
10000000000000000000000000000000000000000000000000000000000000000000000000000000000000000000000000000000000000000000000000C00001
10000000000000000000000000000000000000000000000000000000000000000000000000000000000000000000000000000000000000000000000000C00001
10000000000000000000000000000000000000000000000000000000000000000000000000000000000000000000000000000000000000000000000000C00001
10000000000000000000000000000000000000000000000000000000000000000000000000000000000000000000000000000000000000000000000000C00001
10000000000000000000000000000000000000000000000000000000000000000000000000000000000000000000000000000000000000000000000000C00001
10000000000000000000000000000000000000000000000000000000000000000000000000000000000000000000000000000000000000000000000000C00001
10000000000000000000000000000000000000000000000000000000000000000000000000000000000000000000000000000000000000000000000000C00001
10000000000000000000000000000000000000000000000000000000000000000000000000000000000000000000000000000000000000000000000000C00001
10000000000000000000000000000000000000000000000000000000000000000000000000000000000000000000000000000000000000000000000000C00001
10000000000000000000000000000000000000000000000000000000000000000000000000000000000000000000000000000000000000000000000000C00001
10000000000000000000000000000000000000000000000000000000000000000000000000000000000000000000000000000000000000000000000000C00001
10000000000000000000000000000000000000000000000000000000000000000000000000000000000000000000000000000000000000000000000000C00001
10000000000000000000000000000000000000000000000000000000000000000000000000000000000000000000000000000000000000000000000000C00001
10000000000000000000000000000000000000000000000000000000000000000000000000000000000000000000000000000000000000000000000000C00001
10000000000000000000000000000000000000000000000000000000000000000000000000000000000000000000000000000000000000000000000000C00001
10000000000000000000000000000000000000000000000000000000000000000000000000000000000000000000000000000000000000000000000000C00001
10000000000000000000000000000000000000000000000000000000000000000000000000000000000000000000000000000000000000000000000000C00001
10000000000000000000000000000000000000000000000000000000000000000000000000000000000000000000000000000000000000000000000000C00001
10000000000000000000000000000000000000000000000000000000000000000000000000000000000000000000000000000000000000000000000000C00001
10000000000000000000000000000000000000000000000000000000000000000000000000000000000000000000000000000000000000000000000000C00001
10000000000000000000000000000000000000000000000000000000000000000000000000000000000000000000000000000000000000000000000000C00001
10000000000000000000000000000000000000000000000000000000000000000000000000000000000000000000000000000000000000000000000000C00001
10000000000000000000000000000000000000000000000000000000000000000000000000000000000000000000000000000000000000000000000000C00001
10000000000000000000000000000000000000000000000000000000000000000000000000000000000000000000000000000000000000000000000000C00001
10000000000000000000000000000000000000000000000000000000000000000000000000000000000000000000000000000000000000000000000000C00001
10000000000000000000000000000000000000000000000000000000000000000000000000000000000000000000000000000000000000000000000000C00001
10000000000000000000000000000000000000000000000000000000000000000000000000000000000000000000000000000000000000000000000000C00001
10000000000000000000000000000000000000000000000000000000000000000000000000000000000000000000000000000000000000000000000000C00001
10000000000000000000000000000000000000000000000000000000000000000000000000000000000000000000000000000000000000000000000000C00001
10000000000000000000000000000000000000000000000000000000000000000000000000000000000000000000000000000000000000000000000000C00001
10000000000000000000000000000000000000000000000000000000000000000000000000000000000000000000000000000000000000000000000000C00001
10000000000000000000000000000000000000000000000000000000000000000000000000000000000000000000000000000000000000000000000000C00001
10000000000000000000000000000000000000000000000000000000000000000000000000000000000000000000000000000000000000000000000000C00001
10000000000000000000000000000000000000000000000000000000000000000000000000000000000000000000000000000000000000000000000000C00001
10000000000000000000000000000000000000000000000000000000000000000000000000000000000000000000000000000000000000000000000000C00001
10000000000000000000000000000000000000000000000000000000000000000000000000000000000000000000000000000000000000000000000000C00001
10000000000000000000000000000000000000000000000000000000000000000000000000000000000000000000000000000000000000000000000000C00001
10000000000000000000000000000000000000000000000000000000000000000000000000000000000000000000000000000000000000000000000000C00001
10100000000000000000000000000000000000000000000000000000000000000000000000000000000000000000000000000000000000000000000000C000E1
11111111111111111111111111111111111111111111111111111111111111111111111111111111111111111111111111111111111111111111111111111111